2,2,2,2,2,2,2,2,2,2,2,2
2,1,1,1,1,1,4,5,1,1,1,2
2,1,4,1,1,1,1,1,1,1,1,2
2,1,5,2,2,2,2,2,1,1,1,2
2,1,5,1,1,1,2,2,2,1,5,2
2,2,2,2,4,1,2,2,2,1,4,2
2,1,1,1,1,1,1,1,2,1,1,2
2,1,4,1,1,1,4,1,2,1,1,2
2,1,2,2,1,1,2,1,2,1,1,2
2,1,1,2,4,1,2,5,5,4,1,2
2,5,1,1,1,1,2,1,1,1,1,2
2,2,2,2,2,2,2,2,2,2,2,2
